[pyhmsa.fileformat.exporter]
EMSA = pyhmsa.fileformat.exporter.emsa:ExporterEMSA

[pyhmsa.fileformat.xmlhandler.datum]
AnalysisList0D = pyhmsa.fileformat.xmlhandler.datum.analysislist:AnalysisList0DXMLHandler
ImageRaster2DHyperimage = pyhmsa.fileformat.xmlhandler.datum.imageraster:ImageRaster2DHyperimageXMLHandler
ImageRaster2DSpectral = pyhmsa.fileformat.xmlhandler.datum.imageraster:ImageRaster2DSpectralXMLHandler
AnalysisList1D = pyhmsa.fileformat.xmlhandler.datum.analysislist:AnalysisList1DXMLHandler
Analysis0D = pyhmsa.fileformat.xmlhandler.datum.analysis:Analysis0DXMLHandler
Analysis1D = pyhmsa.fileformat.xmlhandler.datum.analysis:Analysis1DXMLHandler
AnalysisList2D = pyhmsa.fileformat.xmlhandler.datum.analysislist:AnalysisList2DXMLHandler
Analysis2D = pyhmsa.fileformat.xmlhandler.datum.analysis:Analysis2DXMLHandler
ImageRaster2D = pyhmsa.fileformat.xmlhandler.datum.imageraster:ImageRaster2DXMLHandler

[pyhmsa.fileformat.xmlhandler.condition]
AcquisitionRasterXY = pyhmsa.fileformat.xmlhandler.condition.acquisition:AcquisitionRasterXYXMLHandler
SpecimenPosition = pyhmsa.fileformat.xmlhandler.condition.specimenposition:SpecimenPositionXMLHandler
RegionOfInterest = pyhmsa.fileformat.xmlhandler.condition.region:RegionOfInterestXMLHandler
DetectorSpectrometer = pyhmsa.fileformat.xmlhandler.condition.detector:DetectorSpectrometerXMLHandler
DetectorSpectrometerXEDS = pyhmsa.fileformat.xmlhandler.condition.detector:DetectorSpectrometerXEDSXMLHandler
Specimen = pyhmsa.fileformat.xmlhandler.condition.specimen:SpecimenXMLHandler
ElementalIDXray = pyhmsa.fileformat.xmlhandler.condition.elementalid:ElementalIDXrayXMLHandler
AcquisitionPoint = pyhmsa.fileformat.xmlhandler.condition.acquisition:AcquisitionPointXMLHandler
DetectorSpectrometerWDS = pyhmsa.fileformat.xmlhandler.condition.detector:DetectorSpectrometerWDSXMLHandler
AcquisitionMultipoint = pyhmsa.fileformat.xmlhandler.condition.acquisition:AcquisitionMultipointXMLHandler
CompositionElemental = pyhmsa.fileformat.xmlhandler.condition.composition:CompositionElementalXMLHandler
Instrument = pyhmsa.fileformat.xmlhandler.condition.instrument:InstrumentXMLHandler
SpecimenMultilayer = pyhmsa.fileformat.xmlhandler.condition.specimen:SpecimenMultilayerXMLHandler
DetectorSpectrometerCL = pyhmsa.fileformat.xmlhandler.condition.detector:DetectorSpectrometerCLXMLHandler
AcquisitionRasterLinescan = pyhmsa.fileformat.xmlhandler.condition.acquisition:AcquisitionRasterLinescanXMLHandler
AcquisitionRasterXYZ = pyhmsa.fileformat.xmlhandler.condition.acquisition:AcquisitionRasterXYZXMLHandler
ProbeTEM = pyhmsa.fileformat.xmlhandler.condition.probe:ProbeTEMXMLHandler
DetectorCamera = pyhmsa.fileformat.xmlhandler.condition.detector:DetectorCameraXMLHandler
ElementalID = pyhmsa.fileformat.xmlhandler.condition.elementalid:ElementalIDXMLHandler
ProbeEM = pyhmsa.fileformat.xmlhandler.condition.probe:ProbeEMXMLHandler

[pyhmsa.fileformat.xmlhandler.condition.calibration]
CalibrationExplicit = pyhmsa.fileformat.xmlhandler.condition.calibration:CalibrationExplicitXMLHandler
CalibrationConstant = pyhmsa.fileformat.xmlhandler.condition.calibration:CalibrationConstantXMLHandler
CalibrationPolynomial = pyhmsa.fileformat.xmlhandler.condition.calibration:CalibrationPolynomialXMLHandler
CalibrationLinear = pyhmsa.fileformat.xmlhandler.condition.calibration:CalibrationLinearXMLHandler

[pyhmsa.fileformat.importer]
EMSA = pyhmsa.fileformat.importer.emsa:ImporterEMSA

